1111111111111111111111111
1111E000000000000000C1101
11110000000C0000000000101
11110100000011100000C0101
1111010111100000011100101
1111000000000000000000101
11110110000C0011111110101
1111010011100000000000101
1111000001011111111100101
111111111100C000000000101
1111011111111111111110101
11110100C1110000000000101
11110101100000C1111100101
1111000000000000000000101
1111011111111111111110101
11110100000C0000000000101
1111010101011111111100101
1111000000111111110000101
11110111100000000000C0101
1111010000000000000000101
111101010000000C001100101
1111011111C00001111111101
1111P00000000111111110101
1111111111111111111111111
